3 5
O . O | O . O . O
-   -   -   -   .
O . O . O . O . O
.   -   -   -   -
O . O . O . O . O

Problem-solving question 1
