3 4
O | O . O . O
.   .   -   -
O | O . O | O
.   .   .   .
O . O . O | O